Number of tweets 56 
Dominance: 15, share 0.26785714285714285 
Sexual Harassment: 9, share 0.16071428571428573 
Derailing: 0, share 0.0 
Discredit: 30, share 0.5357142857142857 
Stereotype: 2, share 0.03571428571428571 
You are a fucking ugly bitch!shut the fuck up??????????????????????????????????????????????????????you just a ugly bitch!fuck you ??????????	dominance
All you fucking faggots were laughing at her too with that other fucking dumb cunt liberal Ellen DeGeneres	discredit
@MorinBois I know fucker bitch i rode with you one time remember cunt whore? Never again will i fuck around with the fuck around ðŸ˜‚ðŸ˜‚	discredit
@eileenmdm @ldontgotanyhoes I hate you you fucking cunt bitch how fucking dare you I hope you wake up with mad cottâ€¦ https://t.co/XXb8oWQuv9	discredit
You mother fucking piece of trash stupid fucking idiot hoe i hope you fucking die in hell son of a father fucking fuck bitch whore you fucki	sexual_harassment
I'm so fucking horny this morning and my big fat cock is so fucking hard need a horny cock sucking slut or whore to cum and suck me off	sexual_harassment
Wanna be like u could be fucking working for him some day you fucking little slut	discredit
@curvethan fucking hoe ass fucking cunt shut ur fucking dirty ass mouth you fucking bitch im gonna fucking block you	discredit
@femfreq Fuck you and all of your videos you stupid video game criticizing bitch stop fucking talking about things you know nothing about fucker	dominance
@SpIashMan can u report dogshit retard link me after u beg ur fucking terrible u foreign cunt u sound like a woman fucking funder	stereotype
23. the reason that fucking skank ass cunt lied about me was to cover up her shaking my kid, and being in on fucking up lawsuit	discredit
MONIKA WAS RIGHT? RIGHT ABOUT WHAT WHAT DID THAT FUCKING BITCH ASS THOT MOTHERFUCKING HO ASS SKANK SAY TO YOU?	discredit
If only I could get out and beat the cunt that just hit my car with 5 fucking kids in it...cops are fucking looking for you bitch 507TVB	sexual_harassment
Fucking dropped my phone and cracked the screen fucking shit cunt bitch	discredit
Fuck you Noot Noot Harime fucking fashion cunt tailor cunt looking bug as eye looking no arm be having bitch	discredit
FUCKING FUCK SHIT PISS MOTHERFUCKING BITCH TIT CUNT FUCKING SLUT	discredit
@AynRandPaulRyan Fucking bitch sarah fucking lying cunt	discredit
Some cunt at Walmart went full psycho on me saying how she had no fucking space to put her shit bitch ur taking up the entire conveyor belt	discredit
Bitch had the NERVE to leave the fucking box in the mail room you fucking cunt bitch fuck	discredit
@ oomf: SGUT THE FUCK UP NO ONE FUCKIN CARES ABOUT WHAT YOU HAVE TO FUCKING SAY STUPID BITCH ASS CUNT GO SUCK YOUR UGLYASS BOYF DICK	dominance
@lucymilsom2 your just a dirty fuckin whore u got all this chat about me go suck ur fuckin mum u disgusting lil hoe say suttin	discredit
Aye @lostspecimen youre a fucking whore dont fucking speak to me again u fuckin peacock fake ass hoe	dominance
Riding ur shithole like a whore fucker. Conquering ur hole fucking u boipussy in all position & mak u get facial wiâ€¦ https://t.co/I2hHb5sLva	sexual_harassment
@WynslowIsTyping Shut the fuck up you fucking monkey jew bitch cunt nigger dick licking	dominance
Hey @AnnCoulter you fucking cunt ass bitch. Do the world a favor and fucking kill yourself, at least you'll be great to something and not fuck that up.....at least we hope you won't.	sexual_harassment
I fucking know who he cheated with even if he didn't say it. This fucking bitch, I've always fucking hated her two faced whore ass	discredit
u just like me to feel weird thanks holly so fuck u then bitch go fuck yourself childish little girl grow up I hate u I'm glad I don't c u now bitch face I'm not talk on u 2day now fucking cunt	discredit
@piperalex_ Unless cow tipping is classed as physical assault you should shut your fucking whore mouth, i hope you never show your face outside of whatever hole you went to hide in because frankly i would love to drop kick you off a fucking balcony xoxoxo	sexual_harassment
THEN STOP SAYING IT CHRISTINA , fucking pussy stfu stop jocking her she dont be worried bout you you acting like flight	dominance
Another fucking piece of a crap. You have gone too far in chasing mirages, Kashmiri women do not sleep around with RSS men, you fucking cunt, there is no sanity left in you now. You must have heard that phrase. 'Langoor Ke haath angoor' this shit is similar.	discredit
@FeministVoter She fucking called me a "cracker bitch", and you're going to attack me? Nice. Fucking cunt.	discredit
@DDUB789 That bitch is giving me the fuck u I just filled ur glass....Simone is getting 24% instead of 25....thats right whore Im talking to YOU. Oh no, thank you just the bill it was good. (It really fucking wasnt)	discredit
@SocialPowerOne1 You know whats insane Dana!! Is how the NRA continues to get away with fucking murdering children in country! Why dont you shut the fuck up greedy skank !!	dominance
@SunnyLeone @DanielWeber99 you fucking bitch! You don't know a fuck about acting. You're just a fucking whore who's used to getting fucked by random dudes you don't even know.	dominance
@DanReynolds STFU BITCH! AND YOU GO MAKE SOME SATANIC MUSIC U ILLUMINATI WHORE!! Fuck you FUCK IMAGINE DRAGONS You cock sucking maggots	dominance
Woke up angry bc 2 years ago a groomsman &I were supposed to walk into the reception doing the Bernie but this cunt of a bridesmaid insisted that they were gonna do it so we quickly made something up while in line to go and then this fucking bitch walks in & DOESNT FUCKING DO IT	discredit
@DatGaBoii Yea that fucking ass hole mother fucking bitch! GRRRRR	discredit
I just wanna let you know, you're a stupid fucking cunt Go ahead & run your mouth, pussy, I don't give a fuck You're a stupid piece of shit, you're a stupid fucking bitch Get the fuck up off my dick, get the fuck up off my dick, like..- Pink Guy	discredit
If I ever hit you w dumb fucking cunt ass fucking stupid ass fucking bitch just know Im extremely mad at you.	discredit
@SunnyLeone @DanielWeber99 you bitch. You fucking whore. A fucking whore like you gets a chance to act in movies. What about the thousands of struggles we have? You motherfucking bitch! You bitch who doesn't know who her parents are, now acting clean! You	stereotype
Bitch be starting lmao sis "do what you preach"??? Speak for your fucking self you fucking cunt	discredit
Where the fuck is your face scary hoe? Dont be saying nothing about peoples looks when you to pussy to post yours. You bitches can not fucking compete. Sit the fuck down and shut the fuck up. All of you bitches wanna talk about looks, but wheres your pics? Stay in your lane.	dominance
STUPID FUCKING CUNT ASS CUNT BITCH DIDNT STOP AT HER STOP SIGN AND TOTALED MY FUCKING CAR THAT I USE TO MAKE FUCKING MONEY OH MY FUCKING GOD YOU STUPID FUCKING BITCH	discredit
@deplorablem1ke Goddamn fucking bitch shut your fucking flap cunt! Downplaying as if you got game & political power killing all US presidents w/ my civil rights violators bribed in-part 1st family children to run w/criminals & or both monopolize conspirat	dominance
To the guys that loved me,made a relationship with, cheated on me, made false promises. Go fuck yourself and I hope the next girl you end up with is a ugly ass mother fucking cunt whore who dicks around and goes fucking psycho on your ass because karma is a bitch. :)	discredit
@Ruby_Hs Hoe stop fucking lying cause i had her phone for months and its been dead till now bitch& u thought u was being disrespectful 2 my kid,it was meWHERE DA FUCK U AT? she like bitch u acting crazy..dis aint no act bitch.. talk that shit but im gonna	dominance
shut the fuck up you stupud fucking edater , go get some fucking pussy irl you dumb muslim	dominance
@Complex Ok people say Em aint good anymore, yet this shit gets a pass? So much content in this..youre such a fucking hoe, I love it...suck my dick bitch wow...groundbreaking material looking like Roblox characters #pass	discredit
@amaziah_filani What a fucking cunt I hate seeing kids getting neglected and used as parents experiment. So fucking sad. I tell you if I ever saw this whore Id definitely hurt her.	sexual_harassment
Yeah I can't wait till y'all all shut the fuck up about it. Trumps a moron Hillary is a cunt Berney is a fuckin douche they are politicians no matter what one sides gonna bitch and think they hold the moral high ground but guess what we are all the same and most don't give a fuck	discredit
HOW FUCKING DARE YOU LOOK AT HER WHILE CALLING HIM HIS SPIRITUAL SON YOU CUNT FUCKING BITCH	sexual_harassment
@rdag51509914 @OutlawsOW @DallasFuel Who the fuck are you talking to pussy, I stated my point til your bitch ass team beats outlaws in the battle of Texas I dont give a fuck about anything else eat a dick and shut the fuck up	dominance
@RefuSimbi So fucking sexy my QUEEN i can I be that SPECIAL king to spoil you for a WEEKEND are life time suck that pretty pussy and fuck u good plus suck on THEM sexy feet fuck with me BEAUTIFUL	sexual_harassment
@KTHopkins You fucking cunt! You dont take reporting seriously! You fucking and disgusting bitch! You are a disgrace for women. Youre a monster!	discredit
@Marfy_12 1.ur retarded to take yt photo of someone else2.i will when u show ur real3.ur a fuckin bitch ass nigga u fucking cunt4.boii i got ur mum twerking for 5 cents coz dats how poor u fucking really are.5.stop being a fucked up slutty rat	discredit
honestly a bitch didnt deserve shit this whole year or whole fuckin life so why q bitch always complaining ugh fucking hoe	dominance
