Number of tweets 119 
Dominance: 29 
Sexual Harassment: 12 
Derailing: 8 
Discredit: 38 
Stereotype: 32 
@sassybarbara12 @SheriffClarke @FoxNews @FoxBusiness @BreitbartNews Hell, this stupid bitch @Sexytranny1 said I wasn't even black, but a white person in blackface just because I said the NA isn't racist.	discredit
dumbass: why don't women come forward about sexual assault? [women come forward] dumbass: WHORE! LIAR! WHAT WERE YOU WEARING? YOU PROBABLY ASKED FOR IT! dumbass: just don't understand why women don't come forward?	derailing
This is when a guy says something like “I don’t want to date a hoe” n a woman responds with “But you n your sister got different daddies” bitch so...still not dating a hoe lol https://t.co/sMQcWdZnRL	discredit
@lindaws @PennyRed @headhntr The main reason that @pennyred doesn’t want to talk about her experiences with rape and sexual assault is that she is saving the stories for a more lucrative writing gig.	derailing
Its a bitch who better get her some business forreal! How the fuck u gone feel entitled to somebody! Bitch u got blackballed & u gone stay blackballed! I ain't saving no hoe! U is not apart of my Spurs dreams! The woman u see on my page had on the San Antonio Spurs Warm up Jacket	dominance
Liberals are self-identifying as spectacularly stupid, egocentric liars who will say & do anything in pursuit of their self-elevating agendaWant proof?Just watch @CoryBooker & @SenKamalaHarris compete for Most Hysterical Woman at the Kavanaugh hearings#WalkAwayFromDemocrats	stereotype
I will always love you & Ken though @LisaVanderpump I really admire you & feel like a mother tiger with you! I could of jumped through the TV when that skank slapped your face! That upset me! A lot!!!	discredit
@KatiePrice How are they trying to destroy you? You missed your 4 kids first day at school to skank about topless with yet another man. Disgraceful. The kids are better off with their dads where theyre happy, safe & have a stable, loving home...	stereotype
@laurenarankin Ben Sasse is 100% correct. Since 1973, all Ive EVER heard every two years for elections are hysterical women (all a Leftist act) about Back-Alley abortions. This shit is getting old! I didnt hear one other protest issue being yelled about i	stereotype
Left the WH dead broke, but were able to buy 2 million dollar homes and buy their Skank daughter a $10 million dollar apartment. Boy, would I love to see those loan applications and bank statements. Can you smell bank fraud and tax shenanigans? #tcot #maga	discredit
How is it that no law enforcement entity finds it odd that you can leave the WH dead broke and then buy your Skank daughter a $10 million apartment and pay for a $3 million wedding. Have the Clintons ever gone back to Haiti??? #maga #tcot	discredit
Dont you realize youre only making my cock harder with your constant whining, you stupid little bitch? God, your pussy feels so tight when I choke you. I think I might just fill your pussy up right now so you never forget about this day.	sexual_harassment
@sierraplz @afrolivia I bet her parents dont claim her either. This skank blames her miserable existence on immigrants and POC when as an attractive white young woman, she has the privilege to do anything. More trump trash.	dominance
If youre dating a baby daddy before you call the baby mama bitter go talk to her yourself OR just the stfu and mind your business bc you know damn well that nigga gone lie just to get some pussy and play victim. Idc.	dominance
I dont understand who work so hard at sex work. They are so nuts about having sex even in the situation at work. Huh? Youre just another bitch working at the same store. Furthermore, you cant do anything what you are needed and have to. Die bitch die.	sexual_harassment
u just like me to feel weird thanks holly so fuck u then bitch go fuck yourself childish little girl grow up I hate u I'm glad I don't c u now bitch face I'm not talk on u 2day now fucking cunt	discredit
@MissSarah_Jay This is not a concern which is based on any statistical evidence or fact. If we want to discourage men from raping women, maybe actually seriously prosecute them. Because even if you could stop men from pretending to be women to rape women 	derailing
One of the biggest reason I never wanted to come out to my friends was bc I was afraid theyll think I have crush on them when Im just being a decent human being so I call them stupid bitch and a fucking hoe everytime I see them	discredit
@MarshaBlackburn PS - take off that picture-any picture of you makes me want to puke! Any women that would side with Trump is not for any woman or their rights that they should have. You are just another lying Skank GOP white piece of trash! Your commerci	discredit
@piperalex_ Unless cow tipping is classed as physical assault you should shut your fucking whore mouth, i hope you never show your face outside of whatever hole you went to hide in because frankly i would love to drop kick you off a fucking balcony xoxoxo	sexual_harassment
@jalenramsey Lmfao shut the fuck up with your Brentwood Academy havin ass. Yall have one of the worst QBs in the league as far as TD/INT ratio go but you hate on every other quarterback.... Sit your pussy ass down and get swept by the Titans again.	dominance
@tgirlmiller @realDonaldTrump Are you just upset that nobody is grabbing your skank pussy since trumps election is over. Youre an ugly gross old hag and youre also a racist pig and I hope all your children are black	stereotype
MUMMY... NO bitch youll call me DADDY as you choke on my big dick! Youll call me DADDY when I bend you over and strech that cunt wide & split you in two! DADDY knows best. @rtfucker @RT4D1 @RTmutt @BrokeRTPig @RTsubby @rtsucker @RTSlutt @RTFD_ @RTPork @RTPiggyy @RTxxlslave	sexual_harassment
There's a stupid woman on YouTube doing a spirit box saying the most horrendous insensitive things to the 'ghost' of Shan. The silly skank would be conversing with demons and she ain't got cross or nothing to counteract it. And I'm glad leave Shan alone.	discredit
@LindseyGrahamSC @BarackObama @realDonaldTrump Yea, I dont think so asshole . I think your a pussy who has gone corrupt if you werent before , treasonous if you werent already . You were NEVER John McCain's friend . You were never a friend to America . Yo	discredit
@ida_skibenes I dont have Ovaries or a Vagina and I refuse to put women in jeopardy because they do... Pro-choice isnt pro -abortion, its womens right to choose... if you cant get pregnant from rape,STFU.	dominance
Well then call me a sexist, which Im not. This is no doubt a hysterical woman protestor. BTW, there have been several hysterical male protesters but we havent seen news on them. Id say THAT is sexist my dear. Oh, sorry, my dear is sexist? Sorry dolly.	stereotype
@AnnCoulter Ann:Including Sen. Cory Booker as part of your "Most Hysterical Woman"?? Come on now, you cn do better than that. This is so beneath your intellectual acumen and although I disagree with most of what you say, come up with something more origin	derailing
Love seeing how girls publicly compliment each other "Oh wow. Stunnerz. Bae"And in the same breath send private texts to their friends saying the same person is an "insta-whore / attention whore / D-craving attention seeking skank with dumb shoes"Hilarious#MoreThanTwoFaces	discredit
@rdag51509914 @OutlawsOW @DallasFuel Youre**** dumbass I give no fuck about you about your trashass wanna be Texas state team like I said til the beat outlaws in the battle of Texas eat my dick and shut the fuck up, pussy	dominance
I usually dont hate people but I actually hate that bitch. You tried to be friends with me outside of work and then when I had a crisis you decided to be professional and use that against me. Thats the worst type of person. Fucking cunt will get hers though.	discredit
@SECNetwork @ESPNMcGee @MartySmithESPN This is basically a family event like Thanksgiving when the men go to the living room TV to watch football after dinner, while the women stay in the kitchen to gossip	stereotype
@dwmillerus @angiesd789 @SenateMajLdr Yes so obtuse every other country in the fucking world has one. Herp derp. We help fund border walls for other countries then deal with race shaming bullshit from dick lickers like you when we want to protect ourselve	discredit
first goes to bitch ass janelle. FUCK YOU MESSY MF ASS BITCH i literally was on a call with her and her dumb ass twisted my words and ran to tattle on me to ari. like it legit made her pussy wet to go and talk shit abt me so fuck u ill come beat ur ass thats why u stole a listers	sexual_harassment
Im sorry, but this generation of females have no self respect. The internet shouldnt know when youre horny, wet, how good you pussy is & etc. & Yall wonder why these boys treat yall like hoes ! Praying for this generation	discredit
bitch if you dont shut the fuck up and stop acting like the us isnt responsible for the repressive and brutal society that became afghanistan - theres pics of my gma in miniskirts in the 70s in iran, another country destabilized and vilified to drive american profit	dominance
@abitofbrittUS Those pics look like theyre from someone mocking the kind of people who would disrupt hearings. Like if SNL was fair and made fun of these people, the exaggerated version of a hysterical woman disrupting	stereotype
@SenKamalaHarris @SenKamalaHarris You're hystericalYou're hysterical You're hysterical You're hystericalYou're hystericalYou're hysterical You're hystericalYou're hystericalYou're hystericalYou're hystericalYou're hysterical You're hystericalYou're hyster	stereotype
Sounds like @CoryBooker & @KamalaHarris are still competing for most hysterical woman at the hearings. #Pathetic #WeThePeople dont pay you to clutch pearls, or perform one act plays. Get your sh!t together. #ConfirmJudgeKavanaugh #ConfirmKavanaughNOW#WalkAway	stereotype
No room for full explanation here but regarding the hysterical women at the Kavanaugh hearing, the word hysteria is from a Greek word meaning wandering and disconnected uterus. There you have it.	stereotype
Another fucking piece of a crap. You have gone too far in chasing mirages, Kashmiri women do not sleep around with RSS men, you fucking cunt, there is no sanity left in you now. You must have heard that phrase. 'Langoor Ke haath angoor' this shit is similar.	discredit
@AnguloCrystal @Zanderjmurphy @juliabusch_ i dont give a fuck if you started the tweets or if katelyn did. either way you were talking shit to katelyn so i joined this shit bc shes my friend. thats what my point was so shut the fuck up youre a nasty bitch	discredit
@DDUB789 That bitch is giving me the fuck u I just filled ur glass....Simone is getting 24% instead of 25....thats right whore Im talking to YOU. Oh no, thank you just the bill it was good. (It really fucking wasnt)	discredit
@atrupar Thanks MUCH for creating this hearing package. As you can see from my other tweets to you, I have a different take on it all (I agree with Coulter that Booker and Harris are competing for the Hysterical Woman Award) but I really appreciate the wo	stereotype
@LoriCoutler @txdianemaga People in Eu & the US dont seem 2understand that the Muslim refugees coming from the Middle East r very poor, uneducated, &have no respect for women, children or animals.They do what was ok in their country ie rape women, childre	derailing
@ziadwaeladawy Now people want to attack eminem because hes older and they think hes garbage. People have the balls to talk shit now because they think revival is weak and whack but BOYY! Why didnt you pussy fucks respond back then? Scared to get bodied? 	derailing
Ladies want a task for your to do list today? quit talkin to scared lil bitch ass dudes... Some of y'all need to respect yourself enough to tell them to figure shit out & either man up or stfu. Real women ain't got time for that shit! #realtalk -Cardi B	stereotype
@BenSasse @NicolleDWallace He really said this? He loves to blather empty platitudes in front of the camera. And the hysterical women comments? Empty suit. Not buying his Aw, Schucks persona. Right up there with Golly Jeez Gorsuch.	stereotype
@winkfam @cookies1961 @FLOTUS Says the supporter of a woman..@HillaryClinton ....that literally protected & threw every woman under the bus that accused her President husband of rape, affairs, etc. Pleeeeeease, STFU, or educate yourself.	dominance
@tamairaajohnson @Laquondanesia @victooooria09 bitch if only you really wanted all the smoke like yall said yall did. stfu dumb ass hoe, you done said bye 15!times but wanna claim you not retarded, BYE BITCH	dominance
@AnnCoulter What are you worried you are about to lose the crown for Most Hysterical Woman of the decade? Good for them. They are the only ones who are trying to save America while you keep making money off of her by using her. You are the BIGGEST BITCH!!	discredit
@Fashir @jillciminillo I read fine, and likely better than you given my experience. She's an hysterical woman looking for attention and trying to make some sort of issue out of two things that have nothing to do with each other. It's a tennis match. Do yo	stereotype
Ann, actually glad @CoryBooker willing to give up seat to release confidential e-mailsThis will open up floodgates to release Tarmac Bill & Killary Clinton emails@AnnCoulter "#CoryBooker & #KamalaHarris competing for Most Hysterical Woman at Kavanaugh hearings"#MAGA #qanon	stereotype
@Gbaby_5 @collinscody01 @mandaxxbaby @AnoopJo64686365 @savagedewd @YoooooAdrienne Suck these big balls instead you pussy. I would fight you anywhere anyway if you have the balls to step in. Come to Singapore we can sparr there kid.	sexual_harassment
@ajamubaraka Never mind the contempt that the DNC has for its base, giving the nomination to Hillary instead of Bernie, and the contempt Hillary has for the masses calling them "deplorable" and claiming women are stupid and voted how their husbands told t	discredit
niggas want you to ride the dick, choke and die for 30 seconds on the dick, juggle on it, gargle their balls like mouthwash, and control you vaginal walls like youre squeezing a stress ball all for them to give you no type of orgasm. goodnight!	dominance
Look, lady who needs a therapistI know you love when men choke and slap the shit out of you till you cum but not all of us like that. Go put some aloe on that banged up ass of yours and stay off my TL, darlin.	stereotype
Wow, Stupid is as Stupidity does These stupid women are stupid Yet, if they are doing this for Trump I hope he is paying them $15,000 per month to talk,rape and act a fool for him @DiamondandSilk IdIots, Yea you two	discredit
@AnnCoulter Said the flack parroting talking pointsYou wouldnt know courage of convictions or risking your career if you tripped over them and landed right on top of themBtw, hysterical woman is a wonderful, sexist insult. Couldnt resist, huh?	stereotype
Cory Booker and Kamala Harris competing for Most Hysterical Woman at the Kavanaugh hearings, Coulter hilariously tweeted.And yes, liberals immediately got triggered on Twitter, saying her joke was offensive. To them we say, suck it up, snowflakes.	stereotype
Woke up angry bc 2 years ago a groomsman &I were supposed to walk into the reception doing the Bernie but this cunt of a bridesmaid insisted that they were gonna do it so we quickly made something up while in line to go and then this fucking bitch walks in & DOESNT FUCKING DO IT	discredit
@CliffShep @MiaFarrow @realDonaldTrump Shut the fuck up cunt if you actually like Donald trump than you can suck a dick. He is terrible and you are blinded just because of his MONEY!! people dont like cunts bitch	dominance
@MichelleRempel did you fight for women? Ever???? Did you fight against the AESO in our recession? Did you acknowledge sustainability in the context of our energy industry? Ever??? Shut your stupid fucking cunt mouth.	dominance
@AnnCoulter Ann, ever think you might be a bit hysterical yourself. You lost your ability to reason long ago. Not sure when you had the heartectomy. One thing for sure. You don't belong in the human race. Damn.	stereotype
@realDonaldTrump Your followers might not know it but God knows (or whoever is in charge) what kind of lying monster you are. Don't think because you have that skank Paula White by your side that you won't go down in flames.	discredit
@BlackInkChi @VH1 Lily doesnt know the meaning of Loyal. Shes a hothead alcoholic, mad cuz Jr dismissed her, So she runnin to kiss Ryan Ass! Bye Felicia, & take that skank ass Art thief that YOU hired Out the fuck as well!	discredit
!@elenakoshkaxoxo will do anything to be a member of your guild, you can use her up, she loves to choke on cocks and her pussy stays wet all day! Your mission is to prove that you are a sword slinger !	sexual_harassment
I just wanna let you know, you're a stupid fucking cunt Go ahead & run your mouth, pussy, I don't give a fuck You're a stupid piece of shit, you're a stupid fucking bitch Get the fuck up off my dick, get the fuck up off my dick, like..- Pink Guy	discredit
@yikesangeI @betteroffapri @BloodclotBarbie @basically_kai @illegalwhore @hiatusloser You the last bitch that should be talking about looks. Anyways stick that dusty ass tongue back in ya musty STD filled mouth and shut the fuck up hoe.	dominance
Stupid fucking cunt, what you dont like me so youre gonna speed through a stopped bus to what? Try & run me & my 4 year old down? Wanna act like a tough ass, come do it to my face. Dont put my kids safety at risk cause youre a stupid bitch.	sexual_harassment
@reneejess0205 @ColbyCovMMA The skank that looks like half man and half IT actually has the nerve to make fun of someone else's looks?!?! I can't make your kind of stupid or ugly up. Looks like your surgery was a success, congrats, dude. BTW, why do you f	stereotype
@KeelieSturm @CBCNews Muhhhhh privilege? Excuse me? IM OFFENDED!! HATE SPEECH!!! But of course you dont see the slippery slope.And yes, the made up arbitrary term hate speech is free speech. If you choose to get offended by shit, I suggest you get a backb	discredit
@tannerofhides @minimaslany Not to mention that book Claire didn't stay in the kitchen either so the women clearly doesn't know what she's talking about. However yes so much more to women than doing the cooking, cleaning etc.	stereotype
@ABC What a liar - get the story I paid him $380k after the fact because he attacked me. What a skank and so is every woman who looks the other way on this story because of the greater good.	derailing
@TomiLahren Were out in huge numbers and I can say thank you to this skank and who she represents. I wasnt involved until I saw this illiterate hooker and her pimp try to influence others. No ones walking away republican barbie. But those anal warts wont 	discredit
@SaamaanthaaJune @__chelsearenee_ @AverisDope samantha why dont you just shut the fuck up and mind your own damn business. this whole situation HAS NOTHING to do with you, so why you out here running your fat mouth? if she wanted to sell her pussy she wou	sexual_harassment
@SunnyLeone @DanielWeber99 you bitch. You fucking whore. A fucking whore like you gets a chance to act in movies. What about the thousands of struggles we have? You motherfucking bitch! You bitch who doesn't know who her parents are, now acting clean! You	stereotype
@Moonlitelynn @womensmarch @bobblanddesign @CPDAction @lsarsour @TamikaDMallory @UltraViolet @VoteChoice @PPNYCAction @KishaBari @WaywardWinifred @wmnsmarchla They are not representing all women. Theyre representing hysterical women that want to whine and	stereotype
HRC is taking long walks in the woods again. Its sinking in how incompetent and void of solutions she was. She stacked the deck and got her fat butt kicked. What a worthless, pathetic Skank this woman is. #maga #tcot	discredit
STFU SUSAN. Oh yes, PLEASE lets give Trump CREDIT. I mean how else are you able to walk out on the street. Convince yourself that that this CATASTROPHE of a President who you said was better that HRC IS NOT ripping children away from parents seeking asylum, holding children	dominance
Where the fuck is your face scary hoe? Dont be saying nothing about peoples looks when you to pussy to post yours. You bitches can not fucking compete. Sit the fuck down and shut the fuck up. All of you bitches wanna talk about looks, but wheres your pics? Stay in your lane.	dominance
@kimguilfoyle Does it bother you that Jrs kids look at you and think. So thats the skank who had daddys dick in his mouth while he was married to mommy. She is disgusting. You know they think it.	discredit
@deplorablem1ke Goddamn fucking bitch shut your fucking flap cunt! Downplaying as if you got game & political power killing all US presidents w/ my civil rights violators bribed in-part 1st family children to run w/criminals & or both monopolize conspirat	dominance
You don't like Nigerian men. We get it. Go and marry your American or British men. Any small thing, Nigerian men this, Nigerian men that.You're not being a feminist. You're being a man-hating-cretin and it all stems from blowbacks from your greed and bad taste in men. STFU.	discredit
To the guys that loved me,made a relationship with, cheated on me, made false promises. Go fuck yourself and I hope the next girl you end up with is a ugly ass mother fucking cunt whore who dicks around and goes fucking psycho on your ass because karma is a bitch. :)	discredit
@Ruby_Hs Hoe stop fucking lying cause i had her phone for months and its been dead till now bitch& u thought u was being disrespectful 2 my kid,it was meWHERE DA FUCK U AT? she like bitch u acting crazy..dis aint no act bitch.. talk that shit but im gonna	dominance
@pahubb43 Worst thing is if they are that stupid to think he, all by himself, can roll back Roe v Wade then they really need to educate themselves on how SCOTUS works. They are probably being paid like the other hysterical women.	stereotype
Listen skank. Your sugar daddy is the biggest 5x draft-dodging, punk-bitch coward in the COUNTRY. Your opinions mean nothing. You go find a stripper pole, or whatever you did before, STFU about cowardice. ENOUGH! "Melania Trump"	dominance
@Sexyarse69 First ima smack that ass then eat that pussy from the back then wrap your hair around my hand while I choke you and slide in slow and long strokes tease u then start pounding that pussy	sexual_harassment
When Im Eating Pussy For My Pleasure I dont Care if You Nut 8 Times , Smack me in the Head , Run Away, Smash my Head With yo legs , or Cry. IF IM NOT FINISH Bitch Im Not Finish Now Stfu and stop crying	dominance
Yall STAY making post about the LGBT community. You quoted my tweet and started bitching like the insecure little brat you are shut the fuck up and go cry to your mommy. I dont give a fuck about what you have to say.	dominance
#ThursdayThoughts Don't worry Ann. After your multi-day meltdown over having to simply switch seats on a Delta airplane flight last year, we still consider you the "Most Hysterical Woman"	stereotype
@CalioWilliamson @CNN Fucking bitch ! Shes doing that since 2 years when she give money to STUDENTS, STUPID HOE ! Now laugh in silence and poverty ! U want attention and like bcse its trendy ton talk shit about her ??	discredit
@Complex Ok people say Em aint good anymore, yet this shit gets a pass? So much content in this..youre such a fucking hoe, I love it...suck my dick bitch wow...groundbreaking material looking like Roblox characters #pass	discredit
@AliceEvansGruff @cmd51375 @Privacy_Painter @caterita2008 @pat_hardy_ @avaliv_________ @raindovemodel @KSantorri @LizzyBDizzy101 @ggbrokensilence @mae_quez @Jacmalta151 @TakeThatMorals @ClickitH @marczak_rob @elena_audry @VelliniV @snowmancalgary @Lizzie_	derailing
Emily Does vagina had dirt, gravel and pine needles in it after Brock turned raped her while she laid unconscious on the ground. You dont want women to prove they were raped, you want them to accept it and shut the fuck up.	dominance
@KamalaHarris You're a joke Kammy. You couldn't hold Justice Kavanaugh's briefs. Trying to fund raise from the brain dead sheep, regarding a confirmation you can't stop. Race baiting Marxist skank that you are.	discredit
@MoncaMonii I would enjoy standing back to watch you suck cocks and swallow huge loads of cum, while you're helpless. As you suck each cock I'll finger your pussy until you cum, while you choke on cocks and cum! When I do take you home, you'll be exhauste	sexual_harassment
Yeah I can't wait till y'all all shut the fuck up about it. Trumps a moron Hillary is a cunt Berney is a fuckin douche they are politicians no matter what one sides gonna bitch and think they hold the moral high ground but guess what we are all the same and most don't give a fuck	discredit
@rdag51509914 @OutlawsOW @DallasFuel Who the fuck are you talking to pussy, I stated my point til your bitch ass team beats outlaws in the battle of Texas I dont give a fuck about anything else eat a dick and shut the fuck up	dominance
Brown Nose Nikki, You were silent when Donnie talked about his PUSSY GRABBING, You were silent when he call black countries SHIT HOLES, you were silent when he spewed his RACIST VITRIOL, you were silent about CHARLOTTSVILLE. I can go on and on....SO STFU!	dominance
@AngelaBelcamino This just in. Many are saying Trump now at 155% in the polls. Yuge deal, that I can tell you! Witch hunt over. Trump innocent. Crooked Hillary voted ugliest skank of the Decade! Bigly! Trump steaks melt in your mouth like I did Stormy I m	discredit
@RefuSimbi So fucking sexy my QUEEN i can I be that SPECIAL king to spoil you for a WEEKEND are life time suck that pretty pussy and fuck u good plus suck on THEM sexy feet fuck with me BEAUTIFUL	sexual_harassment
@Alyssa_Milano @SenateDems Hi @Alyssa_Milano. Is there a way to get the ladies to stop shouting out during the hearing? It's having the opposite of the desired effect. I love the silent handmaids. But screaming hysterical women is just insulting to the ca	stereotype
Can we just take a second to remember that @kanyewest rapped three months ago Cause now I see women as something to nurture, not something to conquer and now hes yelling out Your such a fucking hoe, I love it	dominance
@DebraMessing how about you STFU with your pro abortion and your racist BS. Ive never seen a pathetic group of people like you democrats so worried about a womans so called right to kill new born infants! You people disgust me! #lookinthemirror	dominance
@LRBitisnot Your words are soooooo descriptive. And now if there was any question about what happened before, now shes just being in in-your-face fucktwaddle because she thinks she got away with it the first time. Fucking bitch...and I dont say that about	discredit
Stupid dumb bitch I hate stupid dumb bitches Like stfu You dumb ass hoe Im so angry That youre dumb and stupid You make no sense Look at you talk out of your mouth Lmaoo BITCH you mad ignorant Be quiet bc you embarass yourself Sorry youre right i am less intelligent	dominance
@USATODAY Shaddup you skank ass immigrant HO, who did you steal that statement from Michelle ... AGAIN ?!? WTF would you know about OUR country, you haven't been here long enough to start that BULL SHIT !!	dominance
These hysterical women would benefit from listening to @DennisPrager. Women should learn to control their emotional, irrational female side the way men have learned to control their aggressive, sexual nature. Men are quite obviously the more evolved of the sexes in this regard.	stereotype
@Marfy_12 1.ur retarded to take yt photo of someone else2.i will when u show ur real3.ur a fuckin bitch ass nigga u fucking cunt4.boii i got ur mum twerking for 5 cents coz dats how poor u fucking really are.5.stop being a fucked up slutty rat	discredit
For crying out loud, Ivanka! STFU you ignorant, grifting, kunt! You pretend to care about women? What about the mothers of the children your father's administration are imprisoning! What about Kavanaugh?	dominance
I was 18 when birth control became legal by the SCOTUS so I found an osteopath that prescribed it to me at 16. Sen Hatch & Sass yelling in the Senate to get those hysterical women out of the chamber was clear the GOP still wants control of women's bodies. #VoteNoOnKavanaugh	stereotype
My grandmother was a maid. Those were the only gigs avaliable to dark skinned women in the very early 1900s. Through her skil set she became a top home economics professional for Chicago wealthy whites. Sent my pops to Unv Chicago, aunt to northwestern. Stfu lil bitch.	discredit
@TheRickWilson Perhaps Ann meant to tweat that she wished she herself had been present to compete for the most hysterical woman? Regarding Kavanaugh, as Harris & Booker's questions revealed, I felt that he was less than decisive, forthright with his answe	stereotype
This is the perfect insult because women are bad, & hysterical women are the worst kind of a bad thing, & the dems are being insulted BY a woman, which is humiliating because women are very bad. Perfect insult by a perfect lady! though thats impossible because ladies are bad,	stereotype
Yes I have a job And I'm pretty damn sure u dont make remotely close to what I make a week working 25 hours than what u make working 80 hours so shut the fuck up. I clearly said on the thread I had time yesterday....whore	dominance
Oh dear, Melania strutting her political thang with fact Contradict her husband and that she should just stay in the kitchen, barefoot and pregnant like Trump wishes we all could return to. The wife should be seen but not heard. Just like in the 50s	stereotype
So I'm working but a friend of mine is telling me that Corey Booker and Kamala harris are fighting for who is the more hysterical woman in the #KavanaughHearings is that true?#Kavanaugh #KavanaughConfirmation	stereotype
