Number of tweets 52 
Dominance: 35, share 0.6730769230769231 
Sexual Harassment: 7, share 0.1346153846153846 
Derailing: 1, share 0.019230769230769232 
Discredit: 9, share 0.17307692307692307 
Stereotype: 0, share 0.0 
@emmasharp003 @Ldrake48Lee Bitch shut the fuck up	dominance
@abzdafab Dear cunt, please shut the fuck up.	dominance
 @queenofdragonsb: Pls shut the fuck up bitch	dominance
@SarahhWaqar @CallmeJaagii Bitch shut the fuck up	dominance
ok babies i'll go to sleep ok bitch shut the fuck up	dominance
You are a fucking ugly bitch!shut the fuck up??????????????????????????????????????????????????????you just a ugly bitch!fuck you ??????????	dominance
 @bnixole: bitch shut the fuck up you're fucking your best friends dad https://t.co/1YR6ydZMgc	dominance
 @vaintshit:  shut the fuck up and come suck my dick "	sexual_harassment
@LadyNadiaEssex Shut the fuck up ye little slag	dominance
@Sundae_3 Shut the fuck up you cunt	dominance
Shut up bitch and suck my cock https://t.co/thFk4yNVEx	sexual_harassment
@anne_theriault @hels Shut up cunt bitch whore	discredit
@BarbeeDani You ain’t shit bitch shut your whore mouth	discredit
@thebradfordfile Sweet. Broke-assed bitch will shut her jizz-hole for once. Once.	dominance
@nonracialnigger Wow shut up you whore	dominance
Pro Tip- Shut the fuck up when you're in my presence	dominance
@RageOnThePage @TwitterMoments Shut the fuck up bitch how do you know what people have and don't have?	sexual_harassment
I can lose weight, but you’ll always be a cunt ♥️ Don’t come at me, I will shut you the fuck down https://t.co/ZuGw6sqK6L	sexual_harassment
@VlCTAH hey fuck you cunt #cyberbullied	sexual_harassment
@loveforjonghyun Shut the FUCK up you jobless whore	discredit
@Slutty_Elf @RiotQuickshot You shut your whore mouth	discredit
@Goguen @MarcuzJauregui @Bathanii Shut the fuck up, you stupid ass bitch	discredit
Fuck off Holly you slag #thismorning	discredit
You Shut Your Whore Mouth!	dominance
@dlh8 @BarackObama Talk about NYers like that AFTER you've survived 9/11. Until then shut the fuck up. You are a nasty skank.	dominance
〝 Bitch fuck shit cunt who─ 〞 Okayyy..	discredit
@lindifferent @solangeknowles @vincestaples Bitch shut cho emo ass up before I rape you	sexual_harassment
@melissafera_ SHUT THE FUCK UP. YOU DUMB WHORE.	dominance
@phiphibb If YOU fuck the rapist then its not rape.	derailing
SHUT UP THE FUCK YOU SLUT!	dominance
@Ronnie2K FUCK YOU STUPID BITCH	dominance
@AdamHargitai007 @Jess_JessP @Playboy Your a bitch who needed to shut his hole	dominance
@BBHMMs fuck you you bitch hole	discredit
@chargenewtwit @NotZelta you gonna shut the fuck up pussy?	dominance
@Ashleyjoyner1 fuck you pussy suckin bitch.	discredit
Bitch stfu	dominance
stfu bitch	dominance
@HillaryClinton shut the fuck up you treasonous bitch of a whore hurry up and die already	dominance
Stfu pussy	dominance
shut the fuck up bitch dont speak on my country or my people	dominance
@joannasbarlow Youre not going to die so shut the fuck up moaning and get in with it	dominance
FUCKING SHUT ME UP BITCH FUCK U U AINT SHIT CUNT FAGGIT BITCH	dominance
I Wanna Rape You Not Fuck You . Bitch Take My Sex & Stfu	sexual_harassment
wow can i stop writing in caps lock we get it, youre hystericalnow shut the fuck up	dominance
Shut the fuck up pls	dominance
@illuminali4all you're a pussy, stfu	dominance
Bitch shut the fuck up	dominance
______________________| | Shut the fuck Up you pussy|______________________| \ / (- )	dominance
If this bitch doesn't shut the fuck up I swear to God	dominance
shut the fuck up you know youre that bitch, whore	dominance
PSAYoure a slut but you dont fuck meBecause you sound like a cry baby bitch shut the fuck up already	dominance
Bitch shut the fuck up and dont talk about Afghanistan	dominance
